C     225,    255,    255
EA ./assets/textures/sky2A.png
NO ./assets/textures/door2A.png
SO ./assets/textures/door2A.png


F     1,1,1

WE ./assets/textures/door2A.png
11111111
   11W011
   11011
   11011
   11011
   11011
   11011
   11011
   11011
   11011
   11011
   11011
   11011
   11011
   11011
   11011
   11011
     11011
   11011
   11011
   11011
   11011
   11011
   11011
   11011
   11011
   11011
   11011
   11011
   11111
11111111
                                                                         1111
1
11
11  11