C     225,    255,    255
EA ./assets/textures/sky2A.png
NO ./assets/textures/door2A.png
SO ./assets/textures/door2A.png


F     1,1,1

WE ./assets/textures/door2A.png
1111 1111
   11S011
   11011
   11011
   11011
   11011
   11011
   11011
   11011
   11011
   11011
   11011
   11011
   11011
   11011
   11011
   11011
     11011
   11011
   11011
   11011
   11011
   11011
   11011
   11011
   11011
   11011
   11011
   11011
   11E11
11111111
                                                                         1111
1
11
11  11