EA ./assets/textures/door2A.png
NO ./assets/textures/wall8A.png
SO ./assets/textures/wall4A.png


F     225,    255,    111   
C     225,    255,    255

WE ./assets/textures/door1A.png
11111111
   11S011
   11011
   11011
   11011
   11011
   11011
   11011
   11011
   11011
   11011
   11011
   11011
   11011
   11011
   11011
   11011
   11011
   11011
   11011
   11011
   11011
   11011
   11011
   11011
   11011
   11011
   11011
   11011
   11011
1111111
