EA ./assets/textures/door2A.png
NO ./assets/textures/sky2A.png
SO ./assets/textures/wall5A.png


F     225,    255,    111   
C     225,    255,    255

WE ./assets/textures/door1A.png
111111
   11N011
   11011
   11011
   11011
   11011
   11011
   11011
   11011
   11011
   11011
   11011
   11011
   11011
   11011
   11011
   11011
   11011
   11011
   11011
   11011
   11011
   11011
   11011
   11011
   11011
   11011
   11011
   11011
   11011
1111111
