R 800 600
NO ./assets/textures/wall1A.png
SO ./assets/textures/wall2A.png
F 220,100,0

WE ./assets/textures/wall3A.png
EA ./assets/textures/wall4A.png




C 225,30,0

111111
100010
10N001
100101
100001
111111







